5 0 0 0 0 0 0 0 0 1
5 0 0 0 0 0 0 0 0 1
1 1 1 1 1 1 1 0 0 4
1 4 0 0 0 0 0 1 0 4
1 4 0 0 0 0 0 0 0 4
1 4 1 1 1 1 1 1 1 1
1 4 0 0 0 0 0 0 0 0
1 4 0 0 0 0 0 0 9 0
1 1 1 1 1 1 1 1 1 1