1 6 6 1 1 1 1 1 1 1
1 0 0 0 0 0 0 0 0 4
1 1 1 1 1 1 1 1 0 4
1 1 1 0 0 0 0 0 0 4
1 4 0 0 1 1 2 1 2 1
1 4 0 1 1 1 1 1 1 1
1 4 0 0 0 0 0 0 0 0
1 4 0 0 0 0 0 0 9 0
1 1 2 2 1 2 2 2 1 1